allData   모든 데이터 arraylist
MyModel    val title: String,
    	val fireCount: Int,
    	val viewCount: Int,
   	 val postID: Int,
   	 val content: String
	이 형식의 모델
mainTitle 	인기글 제목
mainviewCount 	인기글 조회수
mainfireCount 	인기글 공감수
finishpost 	post닫기
posttitle		post안제목
postcontent	post안내용
postfireCount	post안공감숫자
postgoodCount	post안 댓글 좋아요누르는버튼
postbadCount	post안 댓글 싫어요누르는버튼
postcomment	post안 댓글달기	
iFireCount	intent받은좋아요수
iViewCount	intent받은조회수
iPostTitle		intent받은 제목
iContent		intent받은 내용
iComment	댓글내용
select		good클릭했는지 bad클릭했는지
commentHeartCount	댓글창공감수
commentTitle		댓글창 제목
commentFinish		댓글창 닫기
commentGoodCount	댓글창 좋아요
goodCommentGoodReCount 댓글창 좋아요 댓글 좋아요
goodCommentBadReCount	 댓글창 좋아요 댓글 싫어요
GoodCommentComment	 댓글창 좋아요 댓글
commentBadCount		댓글창 싫어요
badCommentGoodReCount	 댓글창 싫어요 댓글 좋아요
badCommentBadReCount	 댓글창 싫어요 댓글 싫어요
badCommentComment	 댓글창 싫어요 댓글